+---+---+---+---+---+---+---+---+---+---+---+---+---+---+---+---+
|       |       |           |       |                   |   |   |
+   +   +   +   +   +   +   +---+   +---+   +   +   +   +   +   +
|   |       |       |   |                   |   |   |           |
+---+---+---+---+   +---+   +---+---+   +---+---+---+   +---+---+
|           |   |       |       |               |       |   |   |
+---+   +   +   +---+   +---+---+   +---+---+   +   +---+   +   +
|   |   |                       |       |       |   |   |   |   |
+   +   +---+   +   +   +---+---+---+---+---+   +---+   +   +   +
|       |       |   |   |   |   |                               |
+   +---+---+---+---+   +   +   +   +   +---+---+---+   +   +---+
|   |           |       |   |       |           |       |   |   |
+   +   +   +   +---+---+   +---+   +---+   +---+   +   +---+   +
|       |   |   |   |       |       |       |   |   |   |       |
+   +---+   +---+   +   +---+---+---+   +---+   +   +   +   +---+
|       |   |       |       |       |   |           |   |       |
+---+   +   +---+   +   +---+   +   +---+---+   +---+   +   +   +
|   |   |   |               |           |       |   |   |   |   |
+   +   +---+---+---+   +   +---+---+   +   +---+   +   +   +---+
|                       |           |           |               |
+---+   +---+   +   +---+---+   +---+   +   +---+---+---+---+---+
|   |   |       |           |   |       |   |       |       |   |
+   +---+   +---+---+   +---+   +   +---+   +   +   +   +   +   +
|           |   |   |   |           |       |   |       |       |
+---+---+   +   +   +   +   +   +   +   +---+---+---+   +---+---+
|       |           |   |       |   |   |   |   |   |   |       |
+   +---+   +---+   +---+---+---+   +---+   +   +   +   +---+   +
|           |                   |   |               |   |       |
+---+---+   +---+---+---+---+---+   +   +---+---+   +   +---+   +
|       |       |   |       |   |       |                       |
+   +   +   +---+   +---+   +   +   +   +---+---+---+   +   +   +
|   |                               |   |               |   |   |
+---+---+---+---+---+---+---+---+---+---+---+---+---+---+---+---+
